ABFs binding site motif  	CACGTGGC  
ABRE binding site motif 	YACGTGGC 
ABRE-like binding site motif 	BACGTGKM 
ACE promoter motif 	GACACGTAGA 
AG binding site motif 	TTDCCWWWWWWGGH 
AG BS in AP3 	CCATTTTTAGT 
AG BS in SUP 	CCATTTTTGG 
AGL1 binding site motif 	NTTDCCWWWWNNGGWAAN 
AGL2 binding site motif 	NNWNCCAWWWWTRGWWAN 
AGL3 binding site motif 	TTWCYAWWWWTRGWAA 
AP1 BS in AP3 	CCATTTTTAG 
AP1 BS in SUP 	CCATTTTTGG 
ARF binding site motif 	TGTCTC 
ARF1 binding site motif 	TGTCTC 
ATHB1 binding site motif 	CAATWATTG 
ATHB2 binding site motif 	CAATSATTG 
ATHB5 binding site motif 	CAATNATTG 
ATHB6 binding site motif 	CAATTATTA 
AtMYB2 BS in RD22 	CTAACCA 
AtMYC2 BS in RD22 	CACATG 
Box II promoter motif 	GGTTAA 
CArG promoter motif 	CCWWWWWWGG 
CArG1 motif in AP3 	GTTTACATAAATGGAAAA 
CArG2 motif in AP3 	CTTACCTTTCATGGATTA 
CArG3 motif in AP3 	CTTTCCATTTTTAGTAAC 
CBF1 BS in cor15a 	TGGCCGAC 
CBF2 binding site motif 	CCACGTGG 
CCA1 binding site motif 	AAMAATCT 
CCA1 motif1 BS in CAB1 	AAACAATCTA 
CCA1 motif2 BS in CAB1 	AAAAAAAATCTATGA 
DPBF1&2 binding site motif 	ACACNNG 
DRE promoter motif 	TACCGACAT 
DREB1&2 BS in rd29a 	TACCGACAT 
DRE-like promoter motif 	DRCCGACNW 
E2F binding site motif 	TTTCCCGC 
E2F/DP BS in AtCDC6 	TTTCCCGC 
E2F-varient binding site motif 	TCTCCCGCC 
EIL1 BS in ERF1 	TTCAAGGGGGCATGTATCTTGAA 
EIL2 BS in ERF1 	TTCAAGGGGGCATGTATCTTGAA 
EIL3 BS in ERF1 	TTCAAGGGGGCATGTATCTTGAA 
EIN3 BS in ERF1 	GGATTCAAGGGGGCATGTATCTTGAATCC 
ERE promoter motif 	TAAGAGCCGCC 
ERF1 BS in AtCHI-B 	GCCGCC 
EveningElement promoter motif 	AAAATATCT 
GATA promoter motif 	WGATAR 
GBF1/2/3 BS in ADH1 	CCACGTGG 
G-box promoter motif 	CACGTG 
GCC-box promoter motif 	GCCGCC 
GT promoter motif 	TGTGTGGTTAATATG 
Hexamer promoter motif 	CCGTCG 
HSEs binding site motif 	AGAANNTTCT 
Ibox promoter motif 	GATAAG 
JASE1 motif in OPR1 	CGTCAATGAA 
JASE2 motif in OPR2 	CATACGTCGTCAA 
L1-box promoter motif 	TAAATGYA 
LS5 promoter motif 	ACGTCATAGA 
LS7 promoter motif 	TCTACGTCAC 
LTRE promoter motif 	ACCGACA 
MRE motif in CHS 	TCTAACCTACCA 
MYB binding site promoter 	MACCWAMC 
MYB1 binding site motif 	MTCCWACC 
MYB2 binding site motif 	TAACTSGTT 
MYB3 binding site motif 	TAACTAAC 
MYB4 binding site motif 	AMCWAMC 
Nonamer promoter motif 	AGATCGACG 
"OBF4,5 BS in GST6 "	ATCTTATGTCATTGATGACGACCTCC 
"OBP-1,4,5 BS in GST6 "	TACACTTTTGG 
OCS promoter motif 	TGACGYAAGSRMTKACGYMA
octamer promoter motif 	CGCGGATC 
PI promoter motif 	GTGATCAC 
PII promoter motif 	TTGGTTTTGATCAAAACCAA 
PRHA BS in PAL1 	TAATTGACTCAATTA 
RAV1-A binding site motif 	CAACA 
RAV1-B binding site motif 	CACCTG 
RY-repeat promoter motif 	CATGCATG 
SBP-box promoter motif 	TNCGTACAA 
T-box promoter motif 	ACTTTG 
TEF-box promoter motif 	AGGGGCATAATGGTAA 
TELO-box promoter motif 	AAACCCTAA 
TGA1 binding site motif 	TGACGTGG 
W-box promoter motif 	TTGAC 
Z-box promoter motif 	ATACGTGT 
AG BS in SPL/NOZ 	AAAACAGAATAGGAAA 
Bellringer/replumless/pennywise BS1 IN AG 	AAATTAAA 
Bellringer/replumless/pennywise BS2 IN AG 	AAATTAGT 
Bellringer/replumless/pennywise BS3 IN AG 	ACTAATTT 
AGL15 BS in AtGA2ox6 	CCAATTTAATGG 
ATB2/AtbZIP53/AtbZIP44/GBF5 BS in ProDH 	ACTCAT 
LFY BS in AP3 	CTTAAACCCTAGGGGTAAT 
SORLREP1 	TT[AT]TACTAGT 
SORLREP2 	ATAAAACGT 
SORLREP3 	TGTATATAT 
SORLREP4 	CTCCTAATT 
SORLREP5 	TTGCATGACT 
SORLIP1 	AGCCAC 
SORLIP2 	GGGCC 
SORLIP3 	CTCAAGTGA 
SORLIP4 	GTATGATGG 
SORLIP5 	GAGTGAG 
