Element Name	Motif Sequence	Source
ABRE1	YACGTGGC	Mochida_et_al
ABRE2	ACGTGKC	Mochida_et_al
CE1	TGCCACCGG	Mochida_et_al
CRT	GGCCGACAT	Mochida_et_al
DRE	TACCGACAT	Mochida_et_al
ICEr2	ACTCCG	Mochida_et_al
MYBR	TGGTTAG	Mochida_et_al
MYCR	CACATG	Mochida_et_al
NACR	ACACGCATGT	Mochida_et_al
-10PEHVPSBD	TATTCT	PLACE
-141NTG13	GCTTTTGATGACTTCAAACAC	PLACE
-284MOTIFZMSBE1	CGTGCAAGCCCAAAGGCCAATCGGCCCAGA	PLACE
-300CORE	TGTAAAG	PLACE
-300ELEMENT	TGHAAARK	PLACE
-300MOTIFZMZEIN	RTGAGTCAT	PLACE
-314MOTIFZMSBE1	ACATAAAATAAAAAAAGGCA	PLACE
14BPATERD1	CACTAAATTGTCAC	PLACE
20NTNTNOS	TGAGCTAAGCACATACGTCA	PLACE
23BPUASNSCYCB1	TTTATTTACCAAACGGTAACATC	PLACE
23BPZM27KDAZEIN	GACGTGTAAAGTAAATTTACAAC	PLACE
27BPDRCONSENSUSPS25S	TCCGCCWCTTGTATTCGTTGCGTTGMA	PLACE
2SSEEDPROTBANAPA	CAAACAC	PLACE
3AF1BOXPSRBCS3	AAATAGATAAATAAAAACATT	PLACE
5256BOXLELAT5256	TGTGGTTATATA	PLACE
5659BOXLELAT5659	GAAWTTGTGA	PLACE
AACACOREOSGLUB1	AACAAAC	PLACE
AACAOSGLUB1	CAACAAACTATATC	PLACE
AAGACGTAGATACL12	AAGACGTAG	PLACE
ABADESI1	RTACGTGGCR	PLACE
ABADESI2	GGACGCGTGGC	PLACE
ABAREG2	ATGTACGAAGC	PLACE
ABASEED1	TGTTACGTGCC	PLACE
ABFOS	GCATCTTTACTTTAGCATC	PLACE
ABRE2HVA1	CCTACGTGGCGG	PLACE
ABRE2HVA22	CGCACGTGTC	PLACE
ABRE3HVA1	GCAACGTGTC	PLACE
ABRE3HVA22	GCCACGTACA	PLACE
ABRE3OSRAB16	GTACGTGGCGC	PLACE
ABREA2HVA1	CCTACGTGGC	PLACE
ABREATCONSENSUS	YACGTGGC	PLACE
ABREATRD22	RYACGTGGYR	PLACE
ABREAZMRAB28	GCCACGTGGG	PLACE
ABREBNNAPA	CGCCACGTGTCC	PLACE
ABREBZMRAB28	TCCACGTCTC	PLACE
ABRECE1HVA22	TGCCACCGG	PLACE
ABRECE3HVA1	ACGCGTGTCCTC	PLACE
ABRECE3ZMRAB28	ACGCGCCTCCTC	PLACE
ABREDISTBBNNAPA	GCCACTTGTC	PLACE
ABRELATERD1	ACGTG	PLACE
ABREMOTIFAOSOSEM	TACGTGTC	PLACE
ABREMOTIFIIIOSRAB16B	GCCGCGTGGC	PLACE
ABREMOTIFIOSRAB16B	AGTACGTGGC	PLACE
ABREOSRAB21	ACGTSSSC	PLACE
ABRERATCAL	MACGYGB	PLACE
ABRETAEM	GGACACGTGGC	PLACE
ABREZMRAB28	CCACGTGG	PLACE
ACEATCHS	GACACGTAGA	PLACE
ACGTABOX	TACGTA	PLACE
ACGTABREMOTIFA2OSEM	ACGTGKC	PLACE
ACGTABREMOTIFAOSOSEM	TACGTGTC	PLACE
ACGTATERD1	ACGT	PLACE
ACGTCBOX	GACGTC	PLACE
ACGTOSGLUB1	GTACGTG	PLACE
ACGTROOT1	GCCACGTGGC	PLACE
ACGTSEED2	ACACACGTCAA	PLACE
ACGTSEED3	GTACGTGGCG	PLACE
ACGTTBOX	AACGTT	PLACE
ACIIIPVPAL2	GTTAGGTTC	PLACE
ACIIPVPAL2	CCACCAACCCCC	PLACE
ACIPVPAL2	CCCACCTACC	PLACE
AGAMOUSATCONSENSUS	TTDCCWWWWWWGGHAA	PLACE
AGATCONSENSUS	TTWCCWWWWNNGGWW	PLACE
AGCBOXNPGLB	AGCCGCC	PLACE
AGL1ATCONSENSUS	NTTDCCWWWWNNGGWAAN	PLACE
AGL2ATCONSENSUS	NNWNCCAWWWWTRGWWAN	PLACE
AGL3ATCONSENSUS	TTWCYAWWWWTRGWAA	PLACE
AGMOTIFNTMYB2	AGATCCAA	PLACE
AGTACSAO	AAAAAGTAAAAAGTAAAAAAGTAAAAAG	PLACE
ALF1NTPARC	TTACGCAAGCAATGACA	PLACE
ALF2NTPARB	TGAGGAGACTTGTGAGGT	PLACE
AMMORESIIUDCRNIA1	GGWAGGGT	PLACE
AMMORESIVDCRNIA1	CGAACTT	PLACE
AMMORESVDCRNIA1	GGCCCCGGG	PLACE
AMYBOX1	TAACARA	PLACE
AMYBOX2	TATCCAT	PLACE
ANAERO1CONSENSUS	AAACAAA	PLACE
ANAERO2CONSENSUS	AGCAGC	PLACE
ANAERO3CONSENSUS	TCATCAC	PLACE
ANAERO4CONSENSUS	GTTTHGCAA	PLACE
ANAERO5CONSENSUS	TTCCCTGTT	PLACE
ANAEROBICCISZMGAPC4	CGAAACCAGCAACGGTCCAG	PLACE
ARE1	RGTGACNNNGC	PLACE
ARECOREZMGAPC4	AGCAACGGTC	PLACE
ARELIKEGHPGDFR2	AGTTGAATGGGGGTGCA	PLACE
ARFAT	TGTCTC	PLACE
ARR1AT	NGATT	PLACE
AS1CAMV	CCACTGACGTAAGGGATGACGCACAATCC	PLACE
AS1LIKECSHPRA	AAATGACGAAAATGC	PLACE
ASF1ATNOS	TGAGCTAAGCACATACGTCAG	PLACE
ASF1MOTIFCAMV	TGACG	PLACE
ASF1NTPARA	TTACGCAAGCAATGACAT	PLACE
AT1BOX	AATATTTTTATT	PLACE
ATHB1ATCONSENSUS	CAATWATTG	PLACE
ATHB2ATCONSENSUS	CAATSATTG	PLACE
ATHB5ATCORE	CAATNATTG	PLACE
ATHB6COREAT	CAATTATTA	PLACE
ATRICHPSPETE	AATATACTAGTATTATTTACTAAAAAAAATC	PLACE
AUXREPSIAA4	KGTCCCAT	PLACE
AUXRETGA1GMGH3	TGACGTAA	PLACE
AUXRETGA2GMGH3	TGACGTGGC	PLACE
B2GMAUX28	CTTGTCGTCA	PLACE
BBOXSITE1STPAT	GCTAAACAAT	PLACE
BIHD1OS	TGTCA	PLACE
BOX1PSGS2	ATAGAAATCAA	PLACE
BOX1PVCHS15	TAAAAGTTAAAAAC	PLACE
BOX2PSGS2	TCTAAGCAAAG	PLACE
BOX2PVCHS15	CTGTGATTAAATAT	PLACE
BOX3PVCHS15	TATTGGTTACTAAA	PLACE
BOXBPSAS1	AAACGACACCGTTT	PLACE
BOXC'PSAS1	TCCCGGTACACACTTCTT	PLACE
BOXCPSAS1	CTCCCAC	PLACE
BOXICHS	GTCCMTCMAACCTAMC	PLACE
BOXIINTPATPB	ATAGAA	PLACE
BOXIIPCCHS	ACGTGGC	PLACE
BOXINTPATPB	AATTCCATAGAATAGATAATA	PLACE
BOXLCOREDCPAL	ACCWWCC	PLACE
BP5OSWX	CAACGTG	PLACE
BS1EGCCR	AGCGGG	PLACE
C1GMAUX28	TGAAAACAGTGAGTTA	PLACE
C1MOTIFZMBZ2	TAACTSAGTTA	PLACE
C2GMAUX28	AATAATAATAATAATAAATA	PLACE
CAATBOX1	CAAT	PLACE
CAATBOX2	GGCCAATCT	PLACE
CACGCAATGMGH3	CACGCAAT	PLACE
CACGTGMOTIF	CACGTG	PLACE
CACTFTPPCA1	YACT	PLACE
CANBNNAPA	CNAACAC	PLACE
CAREOSREP1	CAACTC	PLACE
CARG1ATAP3	GTTTACATAAATGGAAAA	PLACE
CARG2ATAP3	CTTACCTTTCATGGATTA	PLACE
CARG3ATAP3	CTTTCCATTTTTAGTAAC	PLACE
CARGATCONSENSUS	CCWWWWWWGG	PLACE
CARGCW8GAT	CWWWWWWWWG	PLACE
CARGNCAT	CCWWWWWWWWGG	PLACE
CATATGGMSAUR	CATATG	PLACE
CBFHV	RYCGAC	PLACE
CCA1ATLHCB1	AAMAATCT	PLACE
CCAATBOX1	CCAAT	PLACE
CCTCGTGTCTCGMGH3	CCTCGTGTCTC	PLACE
CDA1ATCAB2	CAAAACGC	PLACE
CE3OSOSEM	AACGCGTGTC	PLACE
CELLCYCLESC	CACGAAAA	PLACE
CEREGLUBOX1PSLEGA	TGTTAAAGT	PLACE
CEREGLUBOX2PSLEGA	TGAAAACT	PLACE
CEREGLUBOX3PSLEGA	TGTAAAAGT	PLACE
CGACGOSAMY3	CGACG	PLACE
CGCGBOXAT	VCGCGB	PLACE
CGF1ATCAB2	GATAAAGATTACTTCAGATATAACAAACGTTAC	PLACE
CGTGTSPHZMC1	CGTGTCGTCCATGCAT	PLACE
CIACADIANLELHC	CAANNNNATC	PLACE
CMSRE1IBSPOA	TGGACGG	PLACE
CONSERVED11NTZMATP1	ACGTATTAAAA	PLACE
COREOS	AAKAATWYRTAWATAAAAMTTTTATWTA	PLACE
CPBCSPOR	TATTAG	PLACE
CPRFPCCHS	CCACGTGGCC	PLACE
CRTDREHVCBF2	GTCGAC	PLACE
CTRMCAMV35S	TCTCTCTCT	PLACE
CURECORECR	GTAC	PLACE
CYTOSITECSHPRA	AAGATTGATTGAG	PLACE
D1GMAUX28	ACAGTTACTA	PLACE
D2GMAUX28	ATTTATATAAAT	PLACE
D3GMAUX28	TATTTGCTTAA	PLACE
D4GMAUX28	TAGTGCTGT	PLACE
DE1PSPRA2	GGATTTTACAGT	PLACE
DOFCOREZM	AAAG	PLACE
DPBFCOREDCDC3	ACACNNG	PLACE
DR5GMGH3	CCTTTTGTCTC	PLACE
DRE1COREZMRAB17	ACCGAGA	PLACE
DRE2COREZMRAB17	ACCGAC	PLACE
DRECRTCOREAT	RCCGAC	PLACE
DREDR1ATRD29AB	TACCGACAT	PLACE
E2F1OSPCNA	GCGGGAAA	PLACE
E2FANTRNR	TTTCCCGC	PLACE
E2FAT	TYTCCCGCC	PLACE
E2FBNTRNR	GCGGCAAA	PLACE
E2FCONSENSUS	WTTSSCSS	PLACE
EBOXBNNAPA	CANNTG	PLACE
EECCRCAH1	GANTTNC	PLACE
EIN3ATERF1	GGATTCAAGGGGCATGTATCTTGAATCC	PLACE
ELEMENT1GMLBC3	GATATATTAATATTTTATTTTATA	PLACE
ELEMENT2GMLBC3	CTTAAATTATTTATTT	PLACE
ELRE1PCPAL1	CTCCAACAAACCCCTTC	PLACE
ELRE2PCPAL1	ATTCTCACCTACCA	PLACE
ELRECOREPCRP1	TTGACC	PLACE
ELRENTCHN50	GGTCANNNAGTC	PLACE
EMBP1TAEM	CACGTGGC	PLACE
EMHVCHORD	TGTAAAGT	PLACE
EREGCC	TAAGAGCCGCC	PLACE
ERELEE4	AWTTCAAA	PLACE
ESPASGL01	ACATGTCATCATGT	PLACE
EVENINGAT	AAAATATCT	PLACE
GADOWNAT	ACGTGTC	PLACE
GAGA8HVBKN3	GAGAGAGAGAGAGAGA	PLACE
GAGAGMGSA1	GAGAGAGAGAGAGAGAGA	PLACE
GARE1OSREP1	TAACAGA	PLACE
GARE2	RTAACARANTCYGG	PLACE
GARE2OSREP1	TAACGTA	PLACE
GARE4HVEPB1	GTAACAGAATGCTGG	PLACE
GAREAT	TAACAAR	PLACE
GAREHVAMY1	GGCCGATAACAAACTCCGGCC	PLACE
GATABOX	GATA	PLACE
GBOX10NT	GCCACGTGCC	PLACE
GBOXLERBCS	MCACGTGGC	PLACE
GBOXPC	ACCACGTGGC	PLACE
GBOXRELOSAMY3	CTACGTGGCCA	PLACE
GBOXSORBCS1	TCCACGTGGT	PLACE
GCAACREPEATZMZEIN	GCAACGCAAC	PLACE
GCBP2ZMGAPC4	GTGGGCCCG	PLACE
GCCCORE	GCCGCC	PLACE
GCN4OSGLUB1	TGAGTCA	PLACE
GGTCCCATGMSAUR	GGTCCCAT	PLACE
GLMHVCHORD	RTGASTCAT	PLACE
GLUTAACAOS	AACAAACTCTAT	PLACE
GLUTEBOX1OSGT2	ATATCATGAGTCACTTCA	PLACE
GLUTEBOX1OSGT3	TATCTAGTGAGTCACTTCA	PLACE
GLUTEBOX2OSGT2	TCCGTGTACCA	PLACE
GLUTEBOX2OSGT3	CTTTTGTGTACCTTA	PLACE
GLUTEBP1OS	AAGCAACACACAAC	PLACE
GLUTEBP2OS	ATGCTCAATAGATATAAGT	PLACE
GLUTECOREOS	CTTTCGTGTAC	PLACE
GMHDLGMVSPB	CATTAATTAG	PLACE
GRAZMRAB17	CACTGGCCGCCC	PLACE
GRAZMRAB28	CATGCCGCC	PLACE
GREGIONNTPRB1B	TGGCGGCTCTTATCTCACGTGATG	PLACE
GT1CONSENSUS	GRWAAW	PLACE
GT1CORE	GGTTAA	PLACE
GT1GMSCAM4	GAAAAA	PLACE
GT1MOTIFPSRBCS	KWGTGRWAAWRW	PLACE
GT2OSPHYA	GCGGTAATT	PLACE
GTGANTG10	GTGA	PLACE
HBOXCONSENSUSPVCHS	CCTACCNNNNNNNCT	PLACE
HBOXPVCHS15	CCTACCNNNNNNNCTNNNNA	PLACE
HDMOTIFPCPR2	CTAATTGTTTA	PLACE
HDZIP2ATATHB2	TAATMATTA	PLACE
HDZIPIIIAT	GTAATSATTAC	PLACE
HEXAMERATH4	CCGTCG	PLACE
HEXAT	TGACGTGG	PLACE
HEXMOTIFTAH3H4	ACGTCA	PLACE
HSE	CTNGAANNTTCNAG	PLACE
HSELIKENTACIDICPR1	CNNGAANNNTTCNNG	PLACE
HSELIKENTGLN2	AGGAATTCCT	PLACE
HSRENTHSR203J	CAAAATTTTGTA	PLACE
HY5AT	TGACACGTGGCA	PLACE
IBOX	GATAAG	PLACE
IBOXCORE	GATAA	PLACE
IBOXCORENT	GATAAGR	PLACE
IBOXLSCMCUCUMISIN	AGATATGATAAAA	PLACE
IDE1HVIDS2	ATCAAGCATGCTTCTTGC	PLACE
IDE2HVIDS2	TTGAACGGCAAGTTTCACGCTGTCACT	PLACE
IDRSZMFER1	CACGAGSCCKCCAC	PLACE
INRNTPSADB	YTCANTYY	PLACE
INTRONLOWER	TGCAGG	PLACE
INTRONUPPER	MAGGTAAGT	PLACE
IRO2OS	CACGTGG	PLACE
JASE1ATOPR1	CGTCAATGAA	PLACE
JASE2ATOPR1	CATACGTCGTCAA	PLACE
JERECRSTR	CTCTTAGACCGCCTTCTTTGAAAG	PLACE
L1BOXATPDF1	TAAATGYA	PLACE
L1DCPAL1	ATTCACCTACCC	PLACE
L4DCPAL1	AATCTCCAACCA	PLACE
LBOXLERBCS	AAATTAACCAA	PLACE
LEAFYATAG	CCAATGT	PLACE
LECPLEACS2	TAAAATAT	PLACE
LEGUMINBOXLEGA5	TCCATAGCCATGCAWRCTGMAGAATGTC	PLACE
LREBOX2PSRBCS3	TGTGTGGTTAATATG	PLACE
LREBOX3PSRBCS3	ACTATTTTCACTATC	PLACE
LREBOXIIPCCHS1	TCCACGTGGC	PLACE
LREBOXIPCCHS1	AACCTAACCT	PLACE
LRENPCABE	ACGTGGCA	PLACE
LS5ATPR1	TCTACGTCAC	PLACE
LS7ATPR1	ACGTCATAGA	PLACE
LTRE1HVBLT49	CCGAAA	PLACE
LTREATLTI78	ACCGACA	PLACE
LTRECOREATCOR15	CCGAC	PLACE
MARABOX1	AATAAAYAAA	PLACE
MARARS	WTTTATRTTTW	PLACE
MARCEN3	TGTTTWTGNTTTCCGAAANNNNWWW	PLACE
MARTBOX	TTWTWTTWTT	PLACE
MEJARELELOX	GATACANNAATNTGATG	PLACE
MNF1ZMPPC1	GTGCCCTT	PLACE
MREATCHS	TCTAACCTACCA	PLACE
MRNA3ENDTAH3	AATGGAAATG	PLACE
MRNASTA1CRPSBD	CUCUUTGUTTUU	PLACE
MRNASTA2CRPSBD	UGAGUUG	PLACE
MSACRCYM	AGACCGTTG	PLACE
MYB1AT	WAACCA	PLACE
MYB1LEPR	GTTAGTT	PLACE
MYB26PS	GTTAGGTT	PLACE
MYB2AT	TAACTG	PLACE
MYB2CONSENSUSAT	YAACKG	PLACE
MYBATRD22	CTAACCA	PLACE
MYBCORE	CNGTTR	PLACE
MYBCOREATCYCB1	AACGG	PLACE
MYBGAHV	TAACAAA	PLACE
MYBPLANT	MACCWAMC	PLACE
MYBPZM	CCWACC	PLACE
MYBST1	GGATA	PLACE
MYCATERD1	CATGTG	PLACE
MYCATRD22	CACATG	PLACE
MYCCONSENSUSAT	CANNTG	PLACE
NAPINMOTIFBN	TACACAT	PLACE
NDEGMSAUR	CCATATGCCATGTCTCTCAATTGGTCCCAT	PLACE
NODCON1GM	AAAGAT	PLACE
NODCON2GM	CTCTT	PLACE
NONAMERATH4	AGATCGACG	PLACE
NONAMERMOTIFTAH3H4	CATCCAACG	PLACE
NRRBNEXTA	TAGTGGAT	PLACE
NTBBF1ARROLB	ACTTTA	PLACE
O2F1BE2S1	TCCACGTCGA	PLACE
O2F2BE2S1	GCCACCTCAT	PLACE
O2F3BE2S1	TCCACGTACT	PLACE
OBF5ATGST6	ATCTTATGTCATTGATGACGACCTCC	PLACE
OBP1ATGST6	TACACTTTTGG	PLACE
OCETYPEIIINTHISTONE	GATCCGCGNNNNNNNNNNNNNNACCAATCS	PLACE
OCETYPEIINTHISTONE	TCACGCGGATC	PLACE
OCETYPEINTHISTONE	CCACGTCANCGATCCGCG	PLACE
OCSELEMENTAT	TGACGYAAGSRMTKACGYMM	PLACE
OCSENHANMOTIFAT	ACGTAAGCGCTTACGT	PLACE
OCSGMGH24	CGGTTTACGTAATCTCTTACATCA	PLACE
OCSGMHSP26A	TGATGTAAGAGATTACGTAA	PLACE
OCTAMERMOTIFTAH3H4	CGCGGATC	PLACE
OCTAMOTIF2	CGCGGCAT	PLACE
OPAQUE2ZM22Z	TCCACGTAGA	PLACE
OPAQUE2ZMB32	GATGAYRTGG	PLACE
OSE1ROOTNODULE	AAAGAT	PLACE
OSE2ROOTNODULE	CTCTT	PLACE
P1BS	GNATATNC	PLACE
PALBOXAPC	CCGTCC	PLACE
PALBOXLPC	YCYYACCWACC	PLACE
PALBOXPPC	YTYYMMCMAMCMMC	PLACE
PALINDROMICCBOXGM	TGACGTCA	PLACE
PASNTPARA	TTACGCAAGCAATGACATCT	PLACE
PE1ASPHYA3	GAAATAGCAAATGTTAAAAATA	PLACE
PE2FNTRNR1A	ATTCGCGC	PLACE
PE3ASPHYA3	CAGCTCCCATGGCTCTCCCATCCGCGCCGGT	PLACE
PIATGAPB	GTGATCAC	PLACE
PIIATGAPB	TTGGTTTTGATCAAAACCAA	PLACE
POLASIG1	AATAAA	PLACE
POLASIG2	AATTAAA	PLACE
POLASIG3	AATAAT	PLACE
POLLEN1LELAT52	AGAAA	PLACE
POLLEN2LELAT52	TCCACCATA	PLACE
PR2GCNT	TAARAGCCGCC	PLACE
PREATPRODH	ACTCAT	PLACE
PRECONSCRHSP70A	SCGAYNRNNNNNNNNNNNNNNNHD	PLACE
PREMOTIFNPCABE	ACCGGCCCACTT	PLACE
PROLAMINBOX	CACATGTGTAAAGGT	PLACE
PROLAMINBOXOSGLUB1	TGCAAAG	PLACE
PROXBBNNAPA	CAAACACC	PLACE
PSREGIONZMZM13	TCGGCCACTATTTCTACGGGCAGCCAGACAAA	PLACE
PYRIMIDINEBOXHVEPB1	TTTTTTCC	PLACE
PYRIMIDINEBOXOSRAMY1A	CCTTTT	PLACE
QARBNEXTA	AACGTGT	PLACE
QELEMENTZMZM13	AGGTCA	PLACE
RAV1AAT	CAACA	PLACE
RAV1BAT	CACCTG	PLACE
RBCSBOX2PS	GTGTGGTTAATATG	PLACE
RBCSBOX3PS	ATCATTTTCACT	PLACE
RBCSCONSENSUS	AATCCAA	PLACE
RBCSGBOXPS	CACATGGCACT	PLACE
RBENTGA3	TCCAACTTGGA	PLACE
RE1ASPHYA3	CATGGGCGCGG	PLACE
REALPHALGLHCB21	AACCAA	PLACE
REBETALGLHCB21	CGGATA	PLACE
REGION1OSOSEM	CGGCGGCCTCGCCACG	PLACE
RGATAOS	CAGAAGATA	PLACE
RHERPATEXPA7	KCACGW	PLACE
RNFG1OS	GATCATCGATC	PLACE
RNFG2OS	CCAGTGTGCCCCTGG	PLACE
ROOTMOTIFTAPOX1	ATATT	PLACE
RSEPVGRP1	CAACTTTCATAT	PLACE
RSEPVGRP18	CATCCAACTTTCATATCCATGTGCTT	PLACE
RSRBNEXTA	CAAACTCGTATATCCAT	PLACE
RYREPEAT4	TCCATGCATGCAC	PLACE
RYREPEATBNNAPA	CATGCA	PLACE
RYREPEATGMGY2	CATGCAT	PLACE
RYREPEATLEGUMINBOX	CATGCAY	PLACE
RYREPEATVFLEB4	CATGCATG	PLACE
S1FBOXSORPS1L21	ATGGTA	PLACE
S1FSORPL21	ATGGTATT	PLACE
S2FSORPL21	CCATACATT	PLACE
SARECAMV	CTGACGTAAGGGATGACGCAC	PLACE
SB1NPABC1	CACTAACACAAAGTAA	PLACE
SB3NPABC1	TTATGAACAGTAATT	PLACE
SBOXATRBCS	CACCTCCA	PLACE
SE1PVGRP18	ATAATGGGCCACACTGTGGGGCAT	PLACE
SE2PVGRP1	TTNNNGTAGCTAGTGTATTTGTAT	PLACE
SEBFCONSSTPR10A	YTGTCWC	PLACE
SEF1MOTIF	ATATTTAWW	PLACE
SEF3MOTIFGM	AACCCA	PLACE
SEF4MOTIFGM7S	RTTTTTR	PLACE
SGBFGMGMAUX28	TCCACGTGTC	PLACE
SITE1SORPS1	TCATGGTAACAATT	PLACE
SITE3SORPS1	AGTTAGTTAAAAGA	PLACE
SITEIIAOSPCNA	TGGGCCCGT	PLACE
SITEIIATCYTC	TGGGCY	PLACE
SITEIIBOSPCNA	TGGTCCCAC	PLACE
SITEIOSPCNA	CCAGGTGG	PLACE
SORLIP1AT	GCCAC	PLACE
SORLIP2AT	GGGCC	PLACE
SORLIP3AT	CTCAAGTGA	PLACE
SORLIP4AT	GTATGATGG	PLACE
SORLIP5AT	GAGTGAG	PLACE
SORLREP2AT	ATAAAACGT	PLACE
SORLREP3AT	TGTATATAT	PLACE
SORLREP4AT	CTCCTAATT	PLACE
SORLREP5AT	TTGCATGACT	PLACE
SP8BFIBSP8AIB	ACTGTGTA	PLACE
SP8BFIBSP8BIB	TACTATT	PLACE
SPHCOREZMC1	TCCATGCAT	PLACE
SPHZMC1	CGTCCATGCAT	PLACE
SREATMSD	TTATCC	PLACE
SRENTTTO1	TGGTAGGTGAGAT	PLACE
SURE1STPAT21	AATAGAAAA	PLACE
SURE2STPAT21	AATACTAAT	PLACE
SUREAHVISO1	AAAACTAAGAAAGACCGATGGAAAA	PLACE
SURECOREATSULTR11	GAGAC	PLACE
SV40COREENHAN	GTGGWWHG	PLACE
T/GBOXATPIN2	AACGTG	PLACE
TAAAGSTKST1	TAAAG	PLACE
TACBBFNTEAS4	ACTCTACAGTACTC	PLACE
TATABOX1	CTATAAATAC	PLACE
TATABOX2	TATAAAT	PLACE
TATABOX3	TATTAAT	PLACE
TATABOX4	TATATAA	PLACE
TATABOX5	TTATTT	PLACE
TATABOXOSPAL	TATTTAA	PLACE
TATAPVTRNALEU	TTTATATA	PLACE
TATCCACHVAL21	TATCCAC	PLACE
TATCCAOSAMY	TATCCA	PLACE
TATCCAYMOTIFOSRAMY3D	TATCCAY	PLACE
TBOXATGAPB	ACTTTG	PLACE
TCA1MOTIF	TCATCTTCTT	PLACE
TDBA12NTCHN50	TGACTTTCTGAC	PLACE
TE2F2NTPCNA	ATTCCCGC	PLACE
TEF1BOXATA1	ACAGGGGCATAATGGTAATTTAAA	PLACE
TEFBOXATEEF1AA1	AGGGGCATAATGGTAA	PLACE
TELOBOXATEEF1AA1	AAACCCTAA	PLACE
TGA1ANTPR1A	CGTCATCGAGATGACG	PLACE
TGACGTVMAMY	TGACGT	PLACE
TGTCACACMCUCUMISIN	TGTCACA	PLACE
TL1ATSAR	CTGAAGAAGAA	PLACE
TOPOISOM	GTNWAYATTNATNNG	PLACE
TRANSINITDICOTS	AMNAUGGC	PLACE
TRANSINITMONOCOTS	RMNAUGGC	PLACE
TRANSTART	TAAACAATGGCT	PLACE
UP1ATMSD	GGCCCAWWW	PLACE
UP2ATMSD	AAACCCTA	PLACE
UPRE1AT	ATTGGTCCACG	PLACE
UPRE2AT	CCACGTCATC	PLACE
UPRMOTIFIAT	CCACGTCA	PLACE
UPRMOTIFIIAT	CCNNNNNNNNNNNNCCACG	PLACE
VOZATVPP	GCGTNNNNNNNACGC	PLACE
VSF1PVGRP18	GCTCCGTTG	PLACE
WARBNEXTA	GTACGTGTTATAAAACGTGT	PLACE
WBBOXPCWRKY1	TTTGACY	PLACE
WBOXATNPR1	TTGAC	PLACE
WBOXGACAD1A	AGTCAAAATTGACC	PLACE
WBOXHVISO1	TGACT	PLACE
WBOXNTCHN48	CTGACY	PLACE
WBOXNTERF3	TGACY	PLACE
WINPSTPIIIK	AAGCGTAAGT	PLACE
WRECSAA01	AAWGTATCSA	PLACE
WRKY71OS	TGAC	PLACE
WUSATAg	TTAATGG	PLACE
XYLAT	ACAAAGAA	PLACE
YREGIONNTPRB1B	TGTGACATTGAAATTCTTTGACTTTA	PLACE
ZDNAFORMINGATCAB1	ATACGTGT	PLACE